10x20
********************
*  R        R      *
*   R              *
*                  *
*                  *
*                  *
*           R      *
*                  *
*     H            *
********************