10          x           20
*******O************
*  R        R      *
*   R              *
*           r      *
*                  *
*                  *
*           R      *
*                  *
*     H            *
********************